#0##############0000000E###
#0000000000000000000000####
#0##############0000000####
#00000############00#######
#####000000000000000#####0#
###000#############0###0###
0000###############0#######
0###########0######00000###
000000000000000000000000### 
#####0################0####
#####000000000000000000000#
###########0#0#############
###00000000000#############
##S0000####################